arrange_out0	output	arrange_out0
arrange_out1	output	arrange_out1
arrange_out2	output	arrange_out2
arrange_out3	output	arrange_out3
arrange_out4	output	arrange_out4
arrange_out5	output	arrange_out5
arrange_out6	output	arrange_out6
arrange_out7	output	arrange_out7
arrange_out8	output	arrange_out8
arrange_out9	output	arrange_out9
band	input	band
bit1_add_vld	output	bit1_add_vld
bit2_add_vld	output	bit2_add_vld
bit3_add_vld	output	bit3_add_vld
bit4_add_vld	output	bit4_add_vld
bpc_start_flag	input	bpc_start_flag
bpc_start_flag_delay_1	reg	rMBkqrLcKhflEMUYxGkE
bpc_start_flag_delay_2	reg	wMlYFxkSbZTCTvhQOIei
bpc_start_flag_delay_3	reg	WQGVbnQQZGQWVmpcxvbb
c0	wire	fgBVAEOmiYVjlIISCTIH
c1	wire	PdLWGIyUFHffTRZAsXiT
c10	wire	IEUQfWnHqBExbBpXwbvB
c11	wire	GbYmcGaIlqjpWzdZjqBp
c12	wire	TghzaXxRPdJlXVwzFDAD
c13	wire	YAASZmHihSFveuiuJvLh
c14	wire	ocPDqzzUPgxTaaFQZlAE
c15	wire	kcusTHsweGWDyjtCnIBf
c16	wire	dKkjeMyncyQRxvRIwqPA
c17	wire	EHWbumRhhmCKMpopxvsh
c18	wire	cCnPBAQqvspFpEzzETzl
c19	wire	UYqzkztXutPXfAlntmIe
c2	wire	vhvQKmfEYGSlphsIxeCs
c20	wire	oodnGoVBEFLXRYbIuTZH
c21	wire	UEjSAfHFDOHJVjUcqlyV
c22	wire	KbCXNnOzLNNXshAASoJQ
c23	wire	dZuQNijhFBiKnuZpqbhR
c24	wire	MxeVrIIjXjHhMTtBElyf
c25	wire	kKAPmncZqeprKWNSWaTt
c26	wire	VQgYvKGZkjJJdsVwucAn
c27	wire	ZBAcKCzbbtyGNFJTLssB
c28	wire	CiOSqQnSEhYxmkXsaDND
c29	wire	LDsPXWEPicfpIjiWWkyV
c3	wire	ZrFbZJjPMDHEuYZROGXq
c30	wire	nwCqqIlwmIahIICTFdFZ
c31	wire	QtIuCkNDVwtcSHZjgOQS
c32	wire	LDQqguWjQKoxPNymDyBm
c33	wire	DfputgBBPRNGLqgzPBuA
c4	wire	rNNkvcsqGpEfYTFDzfVx
c5	wire	gSOvAWNVzyvqOdeFdGBD
c6	wire	swvJpulbpsiHraGukmel
c7	wire	MZAAugUMqOwtwlGxrxHD
c8	wire	wiIBdEFJlcmgdYcgLXUm
c9	wire	IjOxLvRkFoEokvDkjrWC
cell31_out	wire	kKDaJKfyhGUjRrYwUzKX
cell32_out	wire	GDZIoCcQuBITjSmBaikb
cell33_out	wire	ljadIVAQTunpolprdLGQ
cell34_out	wire	OxcEJGONRWfXnCqSZXTH
cell35_out	wire	gNgEiixQfJFjHtuQANMI
cell36_out	wire	vtSfmOeSBNpxPquiNIqP
cell37_out	wire	RMsvoDBxWZNHZYyRnucE
cell38_out	wire	odCWwYTcNelybScqPOrq
cell39_out	wire	qamgOkghlPFeFDHIGFOg
cell3a_out	wire	bvJEkPmMozsNjTgxGIjx
cell40_out	wire	qoYkKuhRcFRIEjGVNSYr
cell41_out	wire	UJQCDCcaYonSiaokxDre
cell42_out	wire	XfgkZLFlzjyrDznMrcdV
cell43_out	wire	pDhwqtEHzvhljjKMPTWP
cell44_out	wire	qfjPeklMjDGejTiSfNIt
cell45_out	wire	vrecAxiqQRDsoCHUfiFb
cell46_out	wire	gbkYGwdQTqZWSCtNFrZe
cell47_out	wire	UYZDjbOKWxcSdKfttqUj
cell48_out	wire	tSvfZFkWjBAhoMbTMbGC
cell49_out	wire	xpKEZGLFzrHJpOvPPJaM
cell4a_out	wire	SZXfYOpMhabsiRRCseep
cell50_out	wire	wdktOdkfpRIjBFWRskyy
cell51_out	wire	XtpCtWnmSuWHOsTqZTym
cell52_out	wire	DhkTmLWGgIijHQCsyBGu
cell53_out	wire	dCdOIdQSdpJJEpfVtfcI
cell54_out	wire	xDRSACReidKmHWwBGfrd
cell55_out	wire	uSDdEsjCTtDTYbbzgPYt
cell56_out	wire	mMmeQlGeOWUHeCGZYuFH
cell57_out	wire	BzuLPpKZoBjzJGrJsCNT
cell58_out	wire	qzjxgrtVaWdFUvDXZSlW
cell59_out	wire	aKhjwQvKRXkKESxNpCdv
cell5a_out	wire	RlJbMuoNsFRvRGUndmqJ
cell60_out	wire	aUXkQrNeprUTqroMVQkh
cell61_out	wire	ueGkTdhRmAPwkHUFjCcB
cell62_out	wire	WJgVcZeIlUPAOKNBDkRp
cell63_out	wire	GbyWvndxMseuyAnHwqnn
cell64_out	wire	fgSaGMvdDFsySIwaEFDl
cell65_out	wire	TWNIsjejhhesTXHcPEXR
cell66_out	wire	oOMQdvXrwnziblklWeCC
cell67_out	wire	PRPGGGOZHlXZawqLHheG
cell68_out	wire	sRxxBWOUzCnzaJSwPVis
cell69_out	wire	WUpTDUSrWypCEwLSuGfv
cell6a_out	wire	aosXwrwMOrAgqTMonPEl
cell70_out	wire	wGXyGfTnNwRhTumdiCGF
cell71_out	wire	lYiujcECoGxEWkrYSXyu
cell72_out	wire	FcfzXjMGKuXLyaJFuFYp
cell73_out	wire	aNBYERFSzNqtXSXlqnBT
cell74_out	wire	CJtqbdygHCsrTkXruGSz
cell75_out	wire	bKIkKcnefDXbiSoGbphG
cell76_out	wire	QQmGqPKzzfLgdsKYgOcf
cell77_out	wire	gdYapLlMIvytKkdCPGdF
cell78_out	wire	aCJESItBOvnDmuXhGLUj
cell79_out	wire	cCJQFJSCdvVDIbNwwNYX
cell7a_out	wire	wUTXVpqsmevBpWIEQIcX
cell80_out	wire	arAMQHIzryMkLJaQqtfc
cell81_out	wire	IbJlCRYwAhvuEtwkcBcb
cell82_out	wire	vnkIPwebhyHAOTzzgwVN
cell83_out	wire	lntJsaTLMeamyadjIcTz
cell84_out	wire	qYjtKZZixtZuERqFtmIt
cell85_out	wire	kmnIYqtQigWTYlmkNXLZ
cell86_out	wire	lVoLEEsHkrGIptSSdJcY
cell87_out	wire	SgmCLdndNiIesEfyKaAV
cell88_out	wire	CIiJbWTXRTpdlclBsmUo
cell89_out	wire	mEAXrFrKUcZGRUUUPlCz
cell8a_out	wire	vRiAMmICbUzvsnWJgkIc
cell90_out	wire	TcgQxrdWVGHwfyElUUiW
cell91_out	wire	guNUkxLYmXSQcvDmFJjZ
cell92_out	wire	qLIEqYlgQSYNbeBecRoB
cell93_out	wire	UHncrmKWsoaHDctgdVja
cell94_out	wire	PQSouAAUPcxkmmblfshP
cell95_out	wire	uwxRdnAxqWbPQTUuriZn
cell96_out	wire	SFhHYzgkWQvWPnYCsDQG
cell97_out	wire	wlhWXlRaNWiNUaCsDbir
cell98_out	wire	ZCvoQcyBQrHPNpBpgqWq
cell99_out	wire	DoUSRWVGFusLLetLJBat
cell9a_out	wire	lyzLOaLahwZtRIJhxymQ
cella0_out	wire	LNBmAEdbMEaMLoyGjfrg
cella0_out_vld	wire	ExtHnVBbbCKXmXvjlQbJ
cella1_out	wire	NGUIuhzztIZkaOVpHXkO
cella1_out_vld	wire	fyCXQMODfHLggLbBphNv
cella2_out	wire	PPSQkMpMFizQsBRWIVai
cella2_out_vld	wire	FegNvVfGaRhonmIqphKH
cella3_out	wire	GRuWEivLoABPjtPLXVMJ
cella3_out_vld	wire	XKLIUflcsFaNUXkXzpGV
cella4_out	wire	sKoGsBbnNlQcSJQjwTEW
cella4_out_vld	wire	WGoVpQqTXnVgKMxSubxK
cella5_out	wire	oIGQlTOwKxwTNFHglOMa
cella5_out_vld	wire	kkZHarzgXLRhVsIHWayf
cella6_out	wire	icqejOGfHvoPMyPQlOYY
cella6_out_vld	wire	WSOxsHPzGmWQhcOCvFgt
cella7_out	wire	myNXLrkAdgdxqjfkvzMr
cella7_out_vld	wire	bvwQWDbjMnOESnlTUssU
cella8_out	wire	SQvlodcafgaLzSTpKwZU
cella8_out_vld	wire	ZCyUDUWbyCkGqyuKuIIZ
cella9_out	wire	JFcINZjcavbTjAQKtCAw
cella9_out_vld	wire	upupOTpybpRssnNDEENe
clear0	output	clear0
clk_bpc	input	clk_bpc
clk_dwt	input	clk_dwt
code_over_flag	input	code_over_flag
count_halt	reg	NCLfdSDEGhGvIWQaIuMS
data1_state	input	data1_state
data2_state	input	data2_state
data3_state	input	data3_state
data4_state	input	data4_state
flush	output	flush
flush_mq2	output	flush_mq2
halt	input	halt
halt_bpc	reg	PPgHUmQXljcKYbhzgNbQ
last_stripe_vld	input	last_stripe_vld
level_flag	input	level_flag
lp	reg	FSrEVMbPHefBFwbIYvdr
ls	reg	OHenhlDjGfxNrcoKTDTe
pass_error_start	output	pass_error_start
pass_judge_1	output	pass_judge_1
pass_judge_1_d	output	pass_judge_1_d
pass_judge_2	output	pass_judge_2
pass_judge_2_d	output	pass_judge_2_d
pass_judge_3	output	pass_judge_3
pass_judge_3_d	output	pass_judge_3_d
pass_judge_4	output	pass_judge_4
pass_judge_4_d	output	pass_judge_4_d
r1	reg	aDkQEysUQMjSKApaeshi
r10	reg	LkKGICfCcYyYLBJKtucQ
r100	reg	TuJlheJyAnxHlnuWcoTX
r101	reg	HPrfLvxdntjsoZMlJKSY
r102	reg	QKJtxyiIiIRVzdXpBKWh
r103	reg	psIsKXeoUhGdJicTNQxT
r104	reg	NeXVwDHYZKpxcjzkmkUT
r105	reg	xiBAUFHoQwanlBwVvNGG
r106	reg	DMbtiHjJZmEhNsIuamFJ
r107	reg	kPDQftYnDzJarkoPlEts
r108	reg	ZspMeJBtIQrkBuPFHpVo
r109	reg	sMCgrEPGVWmKmZZcGYZt
r11	reg	UKLUuuVquDsMMMMhkoJV
r110	reg	qbFLLHERyPKsOtwMDakI
r111	reg	cDbXxfwjBJdsAzAvypGt
r112	reg	aCMoPRLpCvfufIiJIMUN
r113	reg	VFQOiBjuGBYSiLhTxnck
r114	reg	oeVMOqpkBmaFOldWHOWz
r115	reg	SFCnSzDSHukMkqWCRsSR
r116	reg	IvfRMxIHjMYRrPLeLBMz
r117	reg	IBKEfbgOWcRSSKcMMgAi
r118	reg	ZfkMwCjiAcEuKVZWEREP
r119	reg	PPhrMbXzyvobhgzdrYUC
r12	reg	AnaDOfYtVBlpyqvNRuwL
r120	reg	QqbfqECqTXMHtIAjfgxN
r121	reg	tdrrNVApyUHiTKJVAhJo
r122	reg	jVmZRNgHGosfqzIvFioH
r123	reg	KjTSVPlCSznxgDeCAMOH
r124	reg	hEgUZvEROWSDHvifIjIQ
r125	reg	bxmJtGgOcSsrWVSlGVfh
r126	reg	yZYWaoARDhVmngMQHaxT
r127	reg	bIqnrkARBAHOajvqLVgA
r128	reg	kQWWWEZXdBZTyhHpshuO
r129	reg	BmfQGwybwXatikdxWoAV
r13	reg	irdAYQxVjzyKmWopQQGP
r130	reg	sbyBpirZUjaSGSxEHWLW
r131	reg	gumzttGlkLctgoLJlWLc
r132	reg	xSguMFEtMTXtKMBkcIRr
r133	reg	LlNyDtIYmDQUcpwyesLo
r134	reg	naamCpnqfhzCWwNkuMSL
r135	reg	oQEdPmbFyDqbjXbahGzM
r136	reg	pQBcvKTUOwJxyTdqyLrJ
r137	reg	qylUKpzxapjYAKMiMDNx
r138	reg	AnZeWrFhEhwvcwkiFCOM
r139	reg	HIuZOCQTPRthrdVKEZBA
r14	reg	daVvNjfwJBQRozThYCld
r140	reg	YiiisWYoYTqYwajkqDuC
r141	reg	VsGUUOtwkcHoVIxvuGPi
r142	reg	rpYGdItNHzbgojcbUMFY
r143	reg	qWVQVMNaFDrFeqIkzufV
r144	reg	IChEtfLugkhsDrwthLKl
r145	reg	eApNvlvUibUYXlIjyyiJ
r146	reg	TZKXYAiBzQHRsPjsQaBX
r147	reg	oVCHkhoYlezUtfkWNxEX
r148	reg	zaOGJQEfTLEBpUaywacy
r149	reg	nUKtZNtPhJNNNmgxqurR
r15	reg	XtrJUtwJnzBPPMzRDosc
r150	reg	ixcGcSoQldNotjgOOoYM
r151	reg	wjPdbOyNQanWDIguicCl
r152	reg	vNBjWwHoPWnZwyRdEAvG
r153	reg	OJxfLuIkrNnSWpokhUXW
r154	reg	iedRhyJcTveKSbgVgPyX
r155	reg	SiWXyZwStCTfnlFxLPQx
r156	reg	ljlzMOdncFtIKCHtOsVQ
r157	reg	sBtkXBZAHFHDVqMZHZdd
r158	reg	ZNywgghYzvszBznGurzE
r159	reg	giByCXZhzRJrKpUfJiYx
r16	reg	jqYKkScMbgeCDBlepdvg
r160	reg	NOzoIRcSVgyFREyzzHqs
r161	reg	hvcttLppSPcVixtVRHqN
r162	reg	NXURaWZymtMESRzASoml
r163	reg	OGJwXjhBDuVzMrVxGthI
r164	reg	tDHSWWPwhDHPIdkjEtEW
r165	reg	spPgPLHCbVgdzOmJFakw
r166	reg	AtkWXjDVDEZLaumbWZzI
r167	reg	HvOvrGAvaPTzYsRxiQFa
r1670	reg	ONSywhEkLUpjhsBVzOEr
r168	reg	rwPuhbqaLGfEsTZJaDhF
r169	reg	YphfuswJNWiAbvgWEfjm
r17	reg	XLyxVCsTIgAfoCPtSMys
r170	reg	YhTJCIYfjiXccwQDAncB
r18	reg	kPRmTzDNbMypwHeWblNC
r181	reg	KaDxyGuuayhqIxIwbGQG
r182	reg	SCcERabQMmiRZhSuKFqS
r183	reg	ASVDnraQDtLQhInOEyVK
r184	reg	RzDedJWchbeEickgtFOM
r185	reg	qBWQIFhDbnPbANWZJPUR
r19	reg	xHakCVQlOGnlmBNRbOYh
r2	reg	FuMFDshlwPAZNriIzdKA
r20	reg	AMpFUyPXvTDKXOABcGwQ
r21	reg	UOxuLGtcikggvdOQzBgR
r22	reg	CsQkcOiTiBTyncfufXZj
r23	reg	FVnQDQCjxSIKkHAsHNWV
r24	reg	KdoJZktdmkwWBKlDvMdP
r25	reg	RaOIZijTYDmTjRjxwtQu
r26	reg	ScyRLdqxTkIfrAjHfyCe
r27	reg	CmTwcTuqlNWMMZwUGiRl
r28	reg	ukbTnNDbmRSfKKceUWrz
r29	reg	UZIbEQrMAwaDCzVroLtq
r2_n	reg	MvoDJNLygtRbAIwfXVCr
r3	reg	BkRGIkRgfMqWorhMRKFM
r30	reg	IjiwjVZQiEWuSfonIrZA
r31	reg	WbcSSJNDDnHYmQYuzLPQ
r32	reg	PJhNpCthKhZROimGgCqU
r33	reg	iJscfdFCjPBfcKkSZVbf
r34	reg	hvcQnhbMPIYQRfXPtdaK
r35	reg	iOLMSFRCeFMeGsFMvGQL
r36	reg	PZQyCgBFWGoAxEUyiNzO
r37	reg	DIvaAYGARSychJVfuaHY
r38	reg	wSCAowmKMCzIwDDaXfFU
r39	reg	yXFXdzGdxaoIkmFBQQEg
r4	reg	wmEBGiAYKWjrjZxZfGew
r40	reg	MWUPIctWCOwXGGiHpLLf
r41	reg	KenTZnwjdIMALELIKQKk
r42	reg	zEUqlZLBLdpXOXXjPGcU
r43	reg	AnjBJxnRNvrmjOYaJdbg
r44	reg	QBOAjUdMyIByZKpqyMhL
r45	reg	jwJehzFhoYfRjtxXBfpX
r46	reg	GQGskmRcyBxJqfiLqYCm
r47	reg	hJbnFyJCwWSCdnyKlTAP
r48	reg	OiPTAsOnkSPKocAtfryA
r49	reg	wPnclwjLvNTvuFBpWQxi
r5	reg	JBFuaKfGSzMztOCsXGjt
r50	reg	ROCrGAVlXuhCUavzlyYo
r51	reg	SChJApzreectmjOkIzBX
r52	reg	RMlFbjHrYqPuugXjOloi
r53	reg	GeDDKVWYIpzkYxFRiAby
r54	reg	iMZueMKdVPHIdaWHnfbE
r55	reg	LxEOjvQABcCaICwJYiyn
r56	reg	MbwejxbltOgmKDxkKTsk
r57	reg	tRZckyVlZtuAOtlwesoj
r58	reg	DzkRrIwaMiNHudDvvzFi
r59	reg	OFZazskRPRGaTQldCVvG
r6	reg	CxvpyAhqMqQXTLpXgdOB
r60	reg	tMINSRlmFWUealRnEpYc
r62	reg	lWqhFaXBuamUEhaBVHlv
r63	reg	hmffJQzxHvHfRtTBYuLG
r64	reg	HwMlSewLUFWHfNzcdCVz
r65	reg	qqzWVPMvDplFUuYiUmck
r66	reg	VyetNAObVKIwVoDtKfHy
r67	reg	AOrHoOiQMOwnAIBkfOCH
r68	reg	qzfrfAzMSXBxGOhKtDPe
r69	reg	JRtwQAVKwrThaZwmPnSu
r7	reg	iGrqtIPPBFPUhGunhSdw
r70	reg	ZTPtJbvUMljVhaDDHqEP
r71	reg	CZceBwenUmhgWecdrVuw
r72	reg	cugZMcaJXKNhJFIYdVSG
r73	reg	qgkpXRmlTwkWNutDGWMM
r74	reg	QvbniyysNCjGSoJYRSJy
r75	reg	hWGjVnLEkDQrysEvjhUk
r76	reg	OTAFvTUooJQuCEUeiOKb
r77	reg	KSjctPBlfoUFuQVMzwRe
r78	reg	UfyHFVwpFQNFelcxnthB
r79	reg	RYUcCJyEjaFkfmUmBpuF
r7_reg	reg	FODhltaveISdQIJPBJhJ
r8	reg	mBUfUweOiYOTkxaNfvqZ
r80	reg	GFJpzOmHZajaMOYgUnwR
r81	reg	JNzZrDqUJYIjSscXpIfs
r82	reg	jIDvdTXgcuXgFwdFLwQs
r83	reg	YeMOMRIeYZPyzXOowtFE
r84	reg	ixURmUmnpqsmlTURRxZg
r85	reg	AldqzOAOgLzSiZYoXvqk
r86	reg	gisHxWFtQvIInGQwAxNb
r87	reg	bbhOGHWAGFziVMGHNWaZ
r88	reg	ngmgnIPJTQQOdZFLMtCN
r89	reg	FgzHiMFOVkCtqVvUqwAJ
r9	reg	XCEBnusbPkduEdkiHxFK
r90	reg	ZXaaduGCBlakrqdXSdjh
r91	reg	wTjVLKCnfjXNfLxzpTmh
r92	reg	HGaDEpyxpcnUKaIqltue
r93	reg	rIvifzIRzwjaNeMXhNUx
r94	reg	aHWKGvWmLBjpxOjkPpzR
r95	reg	zVgIYAxQpqCqkMXZNqdZ
r96	reg	ajGfFSyjcRyvaGpkRcYa
r97	reg	XpJDwRzWkHRCroYHeHRH
r98	reg	oiEumTbeQnFaJdmouriO
r99	reg	uOwYLnkHZVTtMvztMMwV
r9_reg	reg	lIKIHcrXqqitoXmnGNEo
rst	input	rst
rst_syn	input	rst_syn
s1	reg	EKBqBkGyDrNcFHOfjtgn
s10	reg	KBRhkzHtzdoYThlTfbxX
s19	reg	gVMkJmsMEYFtEfiuwaKj
s2	reg	KumgZSySTTIGMUcWgRdh
s20	reg	NxoMdKnjbLmEbfTszmAA
s21	reg	WEZSWrIvxomNfGvFQSiS
s22	reg	ULkqQHcjawmJPPtzcPCS
s23	reg	yHFGaozymIVZZMqtzLDd
s24	reg	XyhfMHNDiNoQgejMGALx
s25	reg	zWhpxSLccsmBmQBUhbQT
s3	reg	HxXYWpNqyqlzgutCIOpi
s4	reg	yzpfeoTAaHHpJpkuQmAL
s5	reg	ghlCNlUzfCnYSTaJpNbT
s6	reg	jLBoLaUfmLsnEHwyAwLL
s7	reg	llosDFMvnCAKMOxOibDN
s8	reg	MrzmNYBuuFEuvAOOCmID
s9	reg	VCUnrYIIgEylHRijrmgt
stall_vld	input	stall_vld
stop_c	reg	NfdfbTCtNjYFDeLLecMe
stop_d	output	stop_d
stop_e	reg	cZtnlbbCHcnJaupBkWiH
stop_flag	input	stop_flag
stripe_over_flag	input	stripe_over_flag
u01_vld	wire	EakVkLNuSPmYJvnabwQm
u1_cxd	wire	EKkouikFTiQAhxGiNBgA
vld_num	output	vld_num
vld_num_temp	reg	lZVGNfUlVmsuLbJxnQDA
w1	wire	TLXWChymSkORZZFunpRb
w10	wire	mtxvjxcqPDeqRFTdOeCy
w11	wire	hJRUqkSdbIbaDoVNyBwV
w12	wire	vyNQySISFoomjfGcZIij
w13	wire	yTGSjqlPczasLIzerqoK
w14	wire	nfEXnqhiCOkZzjflZjMq
w15	wire	DvTzkZIPCHcTKThgKbxF
w16	wire	efILpTiRRkTMGybaFavH
w17	wire	XKEboOlymZUysNbdgYvz
w18	wire	YnUHFWqMbTwhpriTzfCj
w19	wire	mxUXarOdzFVqEXRyKhvn
w2	wire	jMCVmjFKEszeMFGJPhDT
w20	wire	LCnqDiWxDusKfEkYTayX
w21	wire	tbXyWvHmtBVltKRkWupt
w22	wire	vGfKaMkyzbfLNzVNKFuM
w23	wire	FvqlLSYAEuUqbqBPjrJy
w2_reg	reg	OhNfXTYefFZeDsgPpgBQ
w3	wire	SupobFuabxSWuLFQTEEe
w31	wire	xHcIMfHkmMZNUCUTGLMh
w4	wire	BUOYkUPXSUGjGnnMOiLz
w41	wire	ZcufvwoxlnHUTxvmYMrL
w5	wire	dsqvhOxPSNmrxhIMFonB
w6	wire	nUcvoGMUQAyFvkkNKtjY
w7	wire	FtmPDiwqoZcWFUaAxCkO
w8	wire	vNwqhqUgvKlnIAxSJzvz
w9	wire	ZOtXbSepnanqtWVZDuyz
win_a1	reg	FssIYlUsXIkosBplffKR
win_a2	reg	tOmHmkYobOhcasHrvveC
win_a3	reg	HMRNTVVBwfsQwiaIOdeu
win_a4	reg	hGCZylpOryFfZNhxLZOH
win_a5	reg	GVEVAzxUWjnkLWGcHbCC
win_b1	reg	fvbJniljSNczcXeDYDTv
win_b2	reg	artgRMUHHAMMXysfVQxf
win_b3	reg	ZOkiujEkXjtpgkcONTax
win_b4	reg	CcBPKbMCVTPpuzcHaNNl
win_b5	reg	QcQmUnoklSTURFcjjsxj
win_c1	reg	uoqQSqkDyZwtvuETruXA
win_c2	reg	MQgLtHVUbOxalviVAmNV
win_c2_n	reg	vWFpyuXCRPPETqWnXLgO
win_c3	reg	qUkWgSUxlHDGwaShnpJD
win_c3_n	reg	dbsLvjpjMhdBsPiUgbjQ
win_c4	reg	AKnQHFnRxMsayGvtbpFT
win_c4_n	reg	oXZLEogkFzslyJXIZmAm
win_c5	reg	EdvpzeTpOWEloDTnpLTm
win_c5_n	reg	rczbRGCFDOHKNTiwObwc
win_d1	reg	stiszqtCKxtkZisxkQUK
win_d2	reg	GVfnzKKftzXfxeBqPQMD
win_d3	reg	wlenGNqnzNDsKYuoUEFs
win_d4	reg	WVoNBXVHcnpPnosVQmql
win_d5	reg	ObqqhBrMFEWIKEdpaOZE
win_e1	reg	yWJHMVCutPkodurwdxze
win_e2	reg	xOFOFRpZSrifYYEfdruw
win_e2_n	reg	FDTEmqmGIINzAjvyZUbd
win_e3	reg	pBlIpiTyRVEixJQZYAec
win_e3_n	reg	rXbXOOONFccCKhoMrsAV
win_e4	reg	dUuDxKDEFktOVDQPXOkG
win_e4_n	reg	BpSCsagoCaNdVPktxOTV
win_e5	reg	ihLJCGZZFABcRUCnaWQf
win_e5_n	reg	kHkrNHXiGjveuNNRJvzH
