ADDR_WIDTH	parameter	aDkQEysUQMjSKApaeshi
IDLE	parameter	tqCfMxDxNMUeAVjaKWqL
WORD_WIDTH	output	WORD_WIDTH
buffer_all_over	output	buffer_all_over
byte_counter	reg	GVfnzKKftzXfxeBqPQMD
byte_full	wire	ytSqxoZpMDkNRuAUbZDc
cal_truncation_en	wire	jMCVmjFKEszeMFGJPhDT
cal_truncation_point_over	output	cal_truncation_point_over
cal_truncation_point_start	input	cal_truncation_point_start
codeblock_counter	input	codeblock_counter
codeblock_over_counter	reg	daVvNjfwJBQRozThYCld
codeblock_shift_over	output	codeblock_shift_over
compression_ratio	input	compression_ratio
data_from_mq	input	data_from_mq
distoration_tran	reg	bVNTszDvPimBrKwNycBW
dout_plane_cp_0	wire	FODhltaveISdQIJPBJhJ
dout_plane_cp_1	wire	UKLUuuVquDsMMMMhkoJV
dout_plane_mp_0	wire	CZceBwenUmhgWecdrVuw
dout_plane_mp_1	wire	XCEBnusbPkduEdkiHxFK
dout_plane_sp_0	wire	iGrqtIPPBFPUhGunhSdw
dout_plane_sp_1	wire	mBUfUweOiYOTkxaNfvqZ
empty	reg	kAXRTBBnwMdFccjIlXSw
empty_combo	wire	irdAYQxVjzyKmWopQQGP
empty_combo_0	wire	uoqQSqkDyZwtvuETruXA
empty_combo_1	wire	AnaDOfYtVBlpyqvNRuwL
empty_plane_cp_0	wire	EdvpzeTpOWEloDTnpLTm
empty_plane_cp_1	wire	oXZLEogkFzslyJXIZmAm
empty_plane_mp_0	wire	AKnQHFnRxMsayGvtbpFT
empty_plane_mp_1	wire	dbsLvjpjMhdBsPiUgbjQ
empty_plane_sp_0	wire	qUkWgSUxlHDGwaShnpJD
empty_plane_sp_1	wire	vWFpyuXCRPPETqWnXLgO
exponent	reg	ARQLJGuTZBnFJHXDoAkT
exponent_input	reg	ESEFEoPuTgYdvrsaqlOz
fifo_group	reg	eojmGbYrZBcDvhuhplcn
fifo_out	reg	aSItvOfWsSQOkHOHMzuM
flush_over	input	flush_over
flush_over_counter	reg	XtrJUtwJnzBPPMzRDosc
last_codeblock	wire	FuMFDshlwPAZNriIzdKA
lram_write_en	output	lram_write_en
nextstate	reg	euqWRDzuVBfSvNZlbygs
one_codeblock_over	input	one_codeblock_over
one_codeblock_over_reg	reg	nQAnZVgoKyprBQAdRCfA
output_to_ram	reg	QfUEKjFcoDGGRCHDXqcI
over_reg1	reg	XmWQfEltjOUqcNLDCtfd
over_reg2	reg	pyhAjCtAJLKGgXMclzgY
over_reg3	reg	MPFTDVkljwqlROSuxXcP
pass_error	reg	oEDxWLutHlOkrCgasnsy
pass_error_expanded	wire	rczbRGCFDOHKNTiwObwc
pass_error_expanded_shifted	wire	JBFuaKfGSzMztOCsXGjt
pass_error_plane_cp	input	pass_error_plane_cp
pass_error_plane_cp_0_reg	reg	YCteCIAKCruidjpeILHG
pass_error_plane_cp_1_reg	reg	vMLEZaXExwsFFvafFmfc
pass_error_plane_mp	input	pass_error_plane_mp
pass_error_plane_mp_0_reg	reg	xMPttPagqqqJUKztQdOZ
pass_error_plane_mp_1_reg	reg	SVzsQtfHGQqXqNoloxvo
pass_error_plane_sp	input	pass_error_plane_sp
pass_error_plane_sp_0_reg	reg	RdPhRZcalGKJvMOvrAIh
pass_error_plane_sp_1_reg	reg	nxlEkFPUCwQVbIQJmgbx
pass_length_tran	reg	CTJvELJpTGwHTCgirGVs
pass_number	reg	XWSDWJpZwWFziLcqAlai
pass_over_reg	reg	wEtGDzRjafclnvKxgCSP
pass_plane	input	pass_plane
pass_word_count	reg	CHmFHLXDhsSOMWPfgbXw
pass_word_count_expanded	wire	OHenhlDjGfxNrcoKTDTe
pass_word_count_expanded_shifted	wire	CxvpyAhqMqQXTLpXgdOB
rd_clk	input	rd_clk
rd_data_count_plane_cp_0	wire	BUOYkUPXSUGjGnnMOiLz
rd_data_count_plane_cp_1	wire	hGCZylpOryFfZNhxLZOH
rd_data_count_plane_mp_0	wire	SupobFuabxSWuLFQTEEe
rd_data_count_plane_mp_1	wire	HMRNTVVBwfsQwiaIOdeu
rd_data_count_plane_sp_0	wire	LkKGICfCcYyYLBJKtucQ
rd_data_count_plane_sp_1	wire	tOmHmkYobOhcasHrvveC
rd_en_plane_cp_0	wire	QcQmUnoklSTURFcjjsxj
rd_en_plane_cp_1	wire	MQgLtHVUbOxalviVAmNV
rd_en_plane_mp_0	wire	ZOkiujEkXjtpgkcONTax
rd_en_plane_mp_1	wire	CcBPKbMCVTPpuzcHaNNl
rd_en_plane_sp_0	wire	GVEVAzxUWjnkLWGcHbCC
rd_en_plane_sp_1	wire	artgRMUHHAMMXysfVQxf
rears_pass_error	wire	FssIYlUsXIkosBplffKR
rears_pass_word_count	wire	fvbJniljSNczcXeDYDTv
rst	input	rst
rst_syn	input	rst_syn
shift_number	wire	yolIhRYCHLHAYQZvudWh
slope	reg	OhIQvlSNredlAvEzVwlD
slope_table_1	reg	MNhKBwmQfBNRRoCGsGYL
slope_table_10	reg	cYsREsbuuQNtJwVuIQtc
slope_table_100	reg	VXesUOJyNaYiksaASUmr
slope_table_101	reg	MjDYzSbWZYtgtBPeFxFX
slope_table_102	reg	QocIghyhzPXBoGjaFxEW
slope_table_103	reg	aNNRDAQndlQbuwTNoeBC
slope_table_104	reg	ganwYnOuHsVFGlnGQGGf
slope_table_105	reg	TmUIbPULspEIyexiGCHU
slope_table_106	reg	GrWFHsoruHLBTofZiNlc
slope_table_107	reg	HemnvXRItkGWOQQBARSS
slope_table_108	reg	crDvxwhExTyEkehZAJBR
slope_table_109	reg	vqFRiEdZYIvaYIjwIZPo
slope_table_11	reg	IADijSHmLDuBqTQJOxSa
slope_table_110	reg	RiyBtzLqNImqdjYXxYLF
slope_table_111	reg	QAZelRxmduKrKymXyprg
slope_table_112	reg	IixlIEeyecDFQCcIcXFK
slope_table_113	reg	CahtEzYLkeeOsdRKBvoI
slope_table_114	reg	hXvwCaJPKLmTlGnIqShO
slope_table_115	reg	ZapMeflJnJGQFrDdnzZx
slope_table_116	reg	tEZVPsZbWePhmBDkYbkW
slope_table_117	reg	VKIhSekuVtyFcvuoBpZH
slope_table_118	reg	HHissIgZPvjjCfGzZWgP
slope_table_119	reg	ZthEdVQnyODdQJpzqpDX
slope_table_12	reg	BhAYLsocIYeStsZZVTUF
slope_table_120	reg	ZvVAYFyMKYuJjjuLlssM
slope_table_121	reg	BDVfxjBZqdgfpcXaqSxS
slope_table_122	reg	SYPrSAmIZhepjzRpfAbW
slope_table_123	reg	bheecNbLIfuKFYksBrvM
slope_table_124	reg	LoFfmBmHEBmQlYvRihJx
slope_table_125	reg	RAqkMVQdcCkZqHQrYhTY
slope_table_126	reg	JwazcQrhGdLokRSxMIPy
slope_table_127	reg	NHwKTvStgXGxecepjZCb
slope_table_128	reg	iFhOAEkrfnWgTHHMCrAr
slope_table_129	reg	KoZvZIhKhWDYlgwhYWfH
slope_table_13	reg	WQWSkTgEaMFMXPEsFHwg
slope_table_130	reg	xqkVQlUmzixmBBOWsogM
slope_table_131	reg	mZcXpTwcGpwcsXaAXzJZ
slope_table_132	reg	tBkJHywSnDHjCloeCKQN
slope_table_133	reg	rtIOwgMybhKPbMtTkPHH
slope_table_134	reg	ULvOWCBpLiqodnUiPZne
slope_table_135	reg	UeCtXzcgpZHmscgLWNgU
slope_table_136	reg	NchYslfTwDoJDaIhKQld
slope_table_137	reg	vdLrgmXBDTPmGWwCZgJK
slope_table_138	reg	fypmfZbmWDbDCXEismjU
slope_table_139	reg	FEgAuSjALENQXZOiGFUZ
slope_table_14	reg	WVikipTMfwFUtPMyACXK
slope_table_140	reg	hUaTrhFAshrngFoHaXaJ
slope_table_141	reg	avmhenqBbGIfSBAIabaF
slope_table_142	reg	IlmCWYrxdJVqIQywKmAF
slope_table_143	reg	GXKZdRvGRyUFWKyHVAFD
slope_table_144	reg	PExEfPxznaZHuROUSmfc
slope_table_145	reg	DoWtmJCIdGMmwEInsyhi
slope_table_146	reg	AtkWXjDVDEZLaumbWZzI
slope_table_147	reg	HvOvrGAvaPTzYsRxiQFa
slope_table_148	reg	rwPuhbqaLGfEsTZJaDhF
slope_table_149	reg	YphfuswJNWiAbvgWEfjm
slope_table_15	reg	dXrKEPxqSBOppMxaytbW
slope_table_150	reg	YhTJCIYfjiXccwQDAncB
slope_table_151	reg	KaDxyGuuayhqIxIwbGQG
slope_table_152	reg	SCcERabQMmiRZhSuKFqS
slope_table_153	reg	ASVDnraQDtLQhInOEyVK
slope_table_154	reg	RzDedJWchbeEickgtFOM
slope_table_155	reg	qBWQIFhDbnPbANWZJPUR
slope_table_156	reg	ONSywhEkLUpjhsBVzOEr
slope_table_157	reg	SiWXyZwStCTfnlFxLPQx
slope_table_158	reg	ljlzMOdncFtIKCHtOsVQ
slope_table_159	reg	sBtkXBZAHFHDVqMZHZdd
slope_table_16	reg	NnjJwuwNoVWroSgcnSsE
slope_table_160	reg	ZNywgghYzvszBznGurzE
slope_table_161	reg	giByCXZhzRJrKpUfJiYx
slope_table_162	reg	NOzoIRcSVgyFREyzzHqs
slope_table_163	reg	hvcttLppSPcVixtVRHqN
slope_table_164	reg	NXURaWZymtMESRzASoml
slope_table_165	reg	OGJwXjhBDuVzMrVxGthI
slope_table_166	reg	tDHSWWPwhDHPIdkjEtEW
slope_table_167	reg	spPgPLHCbVgdzOmJFakw
slope_table_168	reg	NCLfdSDEGhGvIWQaIuMS
slope_table_169	reg	NfdfbTCtNjYFDeLLecMe
slope_table_17	reg	ASCWICejFoBbZHMJMVyD
slope_table_170	reg	xIHGyzqgFJSHmjAJEkTk
slope_table_171	reg	ffdnbvLvbNGfaiXRKcYD
slope_table_172	reg	dDkKlvBKHVNSwGZicnzg
slope_table_173	reg	sTYRbAXFBXVNlExKcFRO
slope_table_174	reg	QYcegkQFzbKFzvlPxGeR
slope_table_175	reg	WCbGOTtDaZUdMPlupDBN
slope_table_176	reg	kNoeoxFOMGDTBbVzHlLM
slope_table_177	reg	pcsafTpJQiyaKivHSiiO
slope_table_178	reg	HhgKJaIdyWwhlApPzTKC
slope_table_179	reg	LgxgHDHmFYbeGgXVWgvC
slope_table_18	reg	twyoccXqjNTyiiCHZKgQ
slope_table_180	reg	cKBOWdNoOXhznBHdAwlu
slope_table_181	reg	KASZraJCWhbAUtfwnLfk
slope_table_182	reg	AGPbOkqoDAYNiAUBxYWb
slope_table_183	reg	QePGiiHhRVKoAUkzEcSD
slope_table_184	reg	ULkqQHcjawmJPPtzcPCS
slope_table_185	reg	gVMkJmsMEYFtEfiuwaKj
slope_table_186	reg	yHFGaozymIVZZMqtzLDd
slope_table_187	reg	XyhfMHNDiNoQgejMGALx
slope_table_188	reg	zWhpxSLccsmBmQBUhbQT
slope_table_189	reg	xKWgakKpWyTQyBrwYCIS
slope_table_19	reg	xvRCARkQSEXoZFEiGfjC
slope_table_190	reg	UkOdSdYxtcxumOakhLgx
slope_table_191	reg	nhnBLnxptnOVgbmRStCU
slope_table_192	reg	UmXpnIjWZNlfEPEYcDTn
slope_table_193	reg	deblhPqNAplcidEXSGqw
slope_table_194	reg	GgkZJHLDkhyFsCCzuqLa
slope_table_195	reg	pKDUrDrLLWTOdoUxvsyF
slope_table_196	reg	JrQYFpYwpBTANpnTvLiU
slope_table_197	reg	KencLjTnnSFqjwbVxqJg
slope_table_198	reg	TXuaPuUIuhCkLiMhEKiF
slope_table_199	reg	aAhmLslHTfVKwKSRWVtp
slope_table_2	reg	CZUlnpSgUmTCmXxNawKq
slope_table_20	reg	JjLGddxBYbYmoYBVjdju
slope_table_200	reg	NJEYMnPHSmEVDftsqzQE
slope_table_201	reg	ByBgtRovBsKUVHUQEzwk
slope_table_202	reg	pcCSuYOgcgRTEfyKANVf
slope_table_203	reg	OOJGXLeAUSSWDwWKvqMN
slope_table_204	reg	xzObOtBnVrtyMpWImLGp
slope_table_205	reg	fPvbFzCudNRdKXFIwPTW
slope_table_206	reg	UCBlEpPTGRkqheRhrmew
slope_table_207	reg	rxGiYeZlkdsRNUfrmDKO
slope_table_208	reg	BRDRPJjxjaVvUmeEcabW
slope_table_209	reg	twevQhSVcRXlOWMZGHZH
slope_table_21	reg	xyvvBnpUfpnejSAdOrIU
slope_table_210	reg	hsPTsFDtcTjmyeddHGwC
slope_table_211	reg	SnXYHdlnJsKNjOCDlAdk
slope_table_212	reg	fzPjNCWXNlBXDEixcMfx
slope_table_213	reg	MzxTqhCibhKKovZUinvJ
slope_table_214	reg	UjBCIuRFDGUvCwBBwjtv
slope_table_215	reg	WLvkMHkFFjSeXeCMFLqU
slope_table_216	reg	OdXRCGgZgKmtknFfVeGS
slope_table_217	reg	YTagschVaYsVmCoZyGxw
slope_table_218	reg	uBDeqwBeWjkFnJPifZac
slope_table_219	reg	ChqdVbAPIMvlcdCLZFDM
slope_table_22	reg	LNWqJGCGvJkqDqnyFdST
slope_table_220	reg	xVhIWQmsjbKYhycXOZZj
slope_table_221	reg	moXSbLoysxSoGKFutzbo
slope_table_222	reg	pFrrbOJSlADGwICgxTdA
slope_table_223	reg	eFKOOLSSWbJGsojVvoDI
slope_table_224	reg	CjkyDsWsnyjeHKnTfjoz
slope_table_225	reg	ikgPtqNHSxOonFiPgvOK
slope_table_226	reg	JzYgxPBzYqfsNCHdKwWT
slope_table_227	reg	rYlFPAhuURCPKCloqLOG
slope_table_228	reg	PQEjeJZSeiJdTNkqSiiS
slope_table_229	reg	MSaMrnCOKHvvWjrvrLVh
slope_table_23	reg	XXnujvRmwKtqZZbYXNom
slope_table_230	reg	bZovfeygdcHHRKfkxfHl
slope_table_231	reg	ATkQsyvByLEkPXEmCGoF
slope_table_232	reg	uBtJXFukNYPqTHWppmdv
slope_table_233	reg	soNzOmONAzHkpLFWdCtg
slope_table_234	reg	lLJeyDbtTaFvkSfqLcWK
slope_table_235	reg	lMFLPXTVXadwnVsRrAPI
slope_table_236	reg	WPsXEglrQBPoHLKokyap
slope_table_237	reg	RqjRxpMaojbkWLGINNMj
slope_table_238	reg	CcpgUvVvfmeEoXXGYlgz
slope_table_239	reg	yNeJpDTKbQScFfOFsIMP
slope_table_24	reg	rdgcYAhdMEGqsgkVVhHB
slope_table_240	reg	uVWYpFOIjqHtdFWqJLJL
slope_table_241	reg	vCLJZIRyvOOZpamupbmS
slope_table_242	reg	JiRCGeWXVDSjvohYatoO
slope_table_243	reg	JXVeYnVHSdAGpxmDHgjf
slope_table_244	reg	iXlLoGyimBUgUkjZoGvT
slope_table_245	reg	JrBVZVJGLbQlQIuxVRMO
slope_table_246	reg	MZLrRshlRErhPsqJeccP
slope_table_247	reg	KddqRkJXVvlRHkpsKNQL
slope_table_248	reg	eKWoIeUrKiPbRIhuWEla
slope_table_249	reg	JRsyUSbxyBGBNdlJquOD
slope_table_25	reg	bcCzAdPYbGFOdbqFGtNY
slope_table_250	reg	mobFFnIZQLEDGamGRCMQ
slope_table_251	reg	MIfRQTaujrTsVSIdukaO
slope_table_252	reg	qQxKziPkMaoHyxLiZQNv
slope_table_253	reg	SbGofGNBnFvEqTbzCMDT
slope_table_254	reg	eAyuUdQDmhsyVqUkrWtf
slope_table_255	reg	xcrfMbSpXdXRmlkuZRPx
slope_table_256	reg	BKSeIpcsVISDrrWyloru
slope_table_257	reg	cFxrUFXVhwbgFamPfIXu
slope_table_258	reg	EawSFufNSOZZHKtrbfDb
slope_table_259	reg	TtHHtKtzZHIcJuWziTSX
slope_table_26	reg	MRTHuncHaQWNXrTdnjLu
slope_table_260	reg	KAQFclKTjvNuQpWZONVn
slope_table_261	reg	zdDIxzPkCVYUHKycUMxS
slope_table_262	reg	yRWhBghWQtDlHOXzOKHV
slope_table_263	reg	xzEZrlRsvTQMlJcdcoBA
slope_table_264	reg	omKttYZtWwSNmJfXmNhw
slope_table_265	reg	TJsrTmKBrLuIryymjrla
slope_table_266	reg	UQIvtuLZLyNrLBcITiBh
slope_table_267	reg	dewJijMNQrULKORvfOPu
slope_table_268	reg	fFCHqQnaXGJtQcWhDHoo
slope_table_269	reg	lDVujeiDOsfmAcgTJEeH
slope_table_27	reg	ZqxWPnvGQEisPGNSDkWt
slope_table_270	reg	tHYVLHNrDsWBBiksZJSh
slope_table_271	reg	YGcrryHhhucPWCRpoXpV
slope_table_272	reg	vhaFurczuHuVJndQizpm
slope_table_273	reg	bAUZnBUzAeFxTBCaAwBD
slope_table_274	reg	SJSSeEtWLefcHjjHknTt
slope_table_275	reg	RrXElmqzMleQDmHbRetu
slope_table_276	reg	RiwCfvabTaSgTyqQQkNP
slope_table_277	reg	ijLmWvKcGWYkfmVliDIH
slope_table_278	reg	JhZCVmRnYDVfDuTgaJBq
slope_table_279	reg	MmtedWLnvMwKkqgwBoYk
slope_table_28	reg	jLboxjBIZGftrbnYaDHz
slope_table_280	reg	xNONPhZsuWCOqfHyKvVw
slope_table_281	reg	UYtsWPGzDLbsLPHFFzpM
slope_table_282	reg	HaIozTBrCuKZJRqUpAty
slope_table_283	reg	ihhBdoTzqImqsCjVxwKM
slope_table_284	reg	LPKCNZYNtyFJTUiKvFKI
slope_table_285	reg	VcDzTcOFndjUjhnRfxTN
slope_table_286	reg	ScSvdbbLcbwcpTKFudIt
slope_table_287	reg	ZFOGopcNcymIuYXsiiRw
slope_table_288	reg	zVAojGgdEwSIpPjTZZId
slope_table_289	reg	qwGWpRzKYsDLRvxcxAAH
slope_table_29	reg	XPHrltKlkTYeddIYErlL
slope_table_290	reg	WPkpODdzyINGGhuwZyoF
slope_table_291	reg	BaxiLnGgFxSKHVKkEWrL
slope_table_292	reg	cChsgcLGnvNEmegZREam
slope_table_293	reg	FRCWHcmIuMUUWgdYMzWu
slope_table_294	reg	QDYrIGBlnoXdNCUflHOP
slope_table_295	reg	zzYTnLgksIjwqZSweXMf
slope_table_296	reg	cWljGAlocPwsnrDyMjHO
slope_table_297	reg	JPYOnWGSGjFuHZfQBaEZ
slope_table_298	reg	VzfYJEwelHYPMpUSDmsC
slope_table_299	reg	XYQGKDohhXYVCeaCtmre
slope_table_3	reg	GCKDpTZdSkziHIHQTHTY
slope_table_30	reg	DwnEuDbYEGceHCFfntWU
slope_table_300	reg	GbajCDnxXLGTStnsYsds
slope_table_301	reg	THlQvXwjkuLqdcMtPxBy
slope_table_302	reg	avkJIgYNFpvoyRkxaMTC
slope_table_303	reg	yhgnNUWIhVDlrtUDGEZn
slope_table_304	reg	lHvULbFfwhQgtqfjhwzH
slope_table_305	reg	TymwlUFeZUaLhFoWTZzU
slope_table_306	reg	obAWtmAwdFBYPXQlSuSy
slope_table_307	reg	VBJGcheVZYcxGpvcuBoi
slope_table_308	reg	NpcOSbiIpOcdgCjboENs
slope_table_309	reg	PiHYPPmDrZQNPnlqBFSt
slope_table_31	reg	AhXRxsizDLdrPCSJbgvu
slope_table_310	reg	rOXoAhCRFHntxISYSkye
slope_table_311	reg	IsXHeZVJKogNnFFfJwvx
slope_table_312	reg	BtfuDWbiQheMoNKySKtm
slope_table_313	reg	lsMUeaCgYLjCPUiUXaIc
slope_table_314	reg	kTdnGvNmLrhbepFdhZCh
slope_table_315	reg	vKbnovNlLRioZoJsQunL
slope_table_316	reg	nXBrtwwgIArkXUbHKAye
slope_table_317	reg	czvIYhYPaYPpRHUBJMFc
slope_table_318	reg	nsezjQWxmqwzmxCwosDv
slope_table_319	reg	ruIyZIesSthmxIaXEtrJ
slope_table_32	reg	dRLKJNMhCWjmYIXyBBMS
slope_table_320	reg	cXQjLxPFTWRBhlJmdxUJ
slope_table_321	reg	GPoMmfciZsakCXuJMdbD
slope_table_322	reg	sZUCFycPxeatsZozmHJN
slope_table_323	reg	XbnmwpButuNSkogDlbQb
slope_table_324	reg	wdkDXnIkWnpQMmswGQeU
slope_table_325	reg	KpEHEcApUpQBvCLoAeYT
slope_table_326	reg	KsaghLmgaRvpRfCktbJZ
slope_table_327	reg	lZVGNfUlVmsuLbJxnQDA
slope_table_328	reg	rMBkqrLcKhflEMUYxGkE
slope_table_329	reg	wMlYFxkSbZTCTvhQOIei
slope_table_33	reg	qKakmPsWXvxWDjopwmhd
slope_table_330	reg	WQGVbnQQZGQWVmpcxvbb
slope_table_331	reg	AzsKalhmBYUitbArLbcU
slope_table_332	reg	ekrMWzROxYoWtRpdbLZH
slope_table_333	reg	uLMmObkZiwzDlReqMwJN
slope_table_334	reg	eAEEsZkRTlfXOeEdICRO
slope_table_335	reg	DyXCiZssIzbywKGAbIwY
slope_table_336	reg	wBOVUPcFUWzhOUKDlJVa
slope_table_337	reg	BCsgCSHvysHWLteqbRMX
slope_table_338	reg	FrvVghZEElOfAJGPEURk
slope_table_339	reg	DHNpdfPdlvcIeMhPYCBD
slope_table_34	reg	OfKBQrlHgohHRFQMqPuX
slope_table_340	reg	ByKBiFClfZeeoBwNqVdH
slope_table_341	reg	muXlkjUrAqYazTUUGcVg
slope_table_342	reg	rZlIolWetZZffpSrlMAn
slope_table_343	reg	fCxfzzVrwjVhwiuAOpOD
slope_table_344	reg	VHDrEEGVFWccsKXzbEjD
slope_table_345	reg	pgbmZFwAnGMkExuHZexG
slope_table_346	reg	CYTIFZXRYHDOwAOpYhTY
slope_table_347	reg	hzujftnKaamrwjRBenpS
slope_table_348	reg	DwBiXGPwomcqrFUiwGKO
slope_table_349	reg	TxOTbaXnfvTWWAEMVKsT
slope_table_35	reg	OMUVfbzXJtBmpgGUlWIN
slope_table_350	reg	VBPMSBgUzhZWqifRFXLt
slope_table_351	reg	fBEMznDkaUpJbucpUFUs
slope_table_352	reg	RXuUWWKfwotmzMaIdOHs
slope_table_353	reg	DScSrBltRCaJuMKRHxjp
slope_table_354	reg	yKhNJjIQvjuuxuKGtNvD
slope_table_355	reg	MBLbhXLxXGZHZERKIoYb
slope_table_356	reg	AiFthZhNPfZiXSnyPCOt
slope_table_357	reg	uDpYTElkHJsWMgegRIkv
slope_table_358	reg	LqJHECWMJlDdyFDTTZZH
slope_table_359	reg	ohfsyAOCKLVNdUfnlZGT
slope_table_36	reg	pRjKNldSGgrOVpMtRdhl
slope_table_360	reg	MOoDdDePAGBzQbLCZlwX
slope_table_361	reg	MHLazVdHgoSmGTltAxsJ
slope_table_362	reg	CYSqcBzpHDXSSATrgQjL
slope_table_363	reg	rPKZMoWgFDpDSJXXQmEU
slope_table_364	reg	hniufLGfdzmHbDIvsTIo
slope_table_365	reg	wTfPVycgpDcgGCOQhJjH
slope_table_366	reg	lcOMvsbHZmIJccXoDkqZ
slope_table_367	reg	UKirjTCurmcGUGGogrnh
slope_table_368	reg	KVLRCNcgwgdezgxdbtiz
slope_table_369	reg	ISUkQBFCDDhkmXDnEdVT
slope_table_37	reg	FzItXojZYuRrQPYroXqa
slope_table_370	reg	wLiUXxuAUdxCuAoAbUxH
slope_table_371	reg	vQNMUmgdbJJDFKzsjqLK
slope_table_372	reg	PPaVHoPQXNFqYDIgCroQ
slope_table_373	reg	fZmgOJpwMcdeRjEcecxZ
slope_table_374	reg	pXxRQDEgUJLwgwAsNvmV
slope_table_375	reg	JWyFVCrskBwarfgMzbIK
slope_table_376	reg	nLMIykvKsueQiebJRjaB
slope_table_377	reg	MwUAnLVNdEpwKFXarSrE
slope_table_378	reg	rwKFeNNlWzDutFvKudZd
slope_table_379	reg	YFTuhpacOohGrtlEUgyn
slope_table_38	reg	tiASKMApdODRGubKCrIk
slope_table_380	reg	orsjfJIPQQvjIhvrnfZT
slope_table_381	reg	beooHOrejCcWcSXDuAMs
slope_table_382	reg	wLFqLqnhtGKyjhXVaXLu
slope_table_383	reg	VhlEwlgxfirfMpIAJZhE
slope_table_384	reg	ybSCwixJTEhXYyRpEeDj
slope_table_385	reg	PLAwknGzfcioZVaFOQCX
slope_table_386	reg	WdDdHRBJZdBPCxmYbWdk
slope_table_387	reg	BIxIzsQvWljjGYxMCQtS
slope_table_388	reg	TZYUrtPvAdyOAezlYVJO
slope_table_389	reg	qPqZhRZBobhmAXNGrsmh
slope_table_39	reg	AofWIQWGCHGeAWxyBSnX
slope_table_390	reg	BCGaGkllXBcyohBosHqS
slope_table_391	reg	pcgiabuotmBHXKOYDDAq
slope_table_392	reg	VidvAsXIfsppEpKtZeYc
slope_table_393	reg	lGfaCxQtDihDBzWEuyaH
slope_table_394	reg	ucwrtDfHQDZIjkmTmCvN
slope_table_395	reg	dayIzRpYaQRnEjXynbCm
slope_table_396	reg	vqgpItmCwuhiwKZyFXMt
slope_table_397	reg	FnVEwsGKlXZfUqxZGqHn
slope_table_398	reg	bitnzrgsExKEWSXnsRZq
slope_table_399	reg	eYsNwIgUOqnSppAZBKfW
slope_table_4	reg	TbggffYtMBhiLSACnOtm
slope_table_40	reg	BVZJHRZIRDJUNzlhOXNj
slope_table_400	reg	FXTNpbkOJRifihZRkFUk
slope_table_401	reg	UCyPKegIVHgIqztViRHP
slope_table_402	reg	urwbynurHojveDuzQAqY
slope_table_403	reg	djsdiJHbeUEoOocTIVAL
slope_table_404	reg	juEeWiBDxjlSPOBoDWca
slope_table_405	reg	ZfhQiwfaJoKgwqVVBKhf
slope_table_406	reg	SNnVNrhdPUfxhixiespl
slope_table_407	reg	cHHoYqPSIzoxFEuXvNLY
slope_table_408	reg	hLpCUWbILJOjqbDhVEwn
slope_table_409	reg	itXQCyFacJzvPyzfGwVe
slope_table_41	reg	MJngMbRNrQAqZKOoJbfA
slope_table_410	reg	iujmIQQClXPYAKjueUBD
slope_table_411	reg	BjdcbpGuKPxnpZzFTfte
slope_table_412	reg	ZQFzyLJsVraTCGkqQcZA
slope_table_413	reg	fADZyEOwTyWvSQFgOnwG
slope_table_414	reg	xbhqvpXrDTlnyBNQeAlC
slope_table_415	reg	usigvHtlPqTHmByMEGLy
slope_table_416	reg	EqRnSoIxQaLPlCNmpBmq
slope_table_417	reg	VzsEzvUFwafgXDXiMnOI
slope_table_418	reg	qjQChEpAPSbKmoDGRppN
slope_table_419	reg	XBdmfGxuWrXGMBFOANKF
slope_table_42	reg	LKEbaiUcnUkcdhTlxIWn
slope_table_420	reg	iHWmgCopJntOccGPObxn
slope_table_421	reg	eeoTbTyuwxPCsjuUGnLj
slope_table_422	reg	MkxrURKJtUzHVTfBwhoO
slope_table_423	reg	USFkaPtDBVOjbGpLXKUX
slope_table_424	reg	xcBSpPXNgyeMCKwBcsxX
slope_table_425	reg	APZhwjfiYOuKluWEaTIj
slope_table_426	reg	eiYeGwmYgODBCzcNuNtn
slope_table_427	reg	rmoQVcRSrSeskIibJzCc
slope_table_428	reg	AzSDmFqniQGEkrUvtcQd
slope_table_429	reg	BYQMYRDRDKXGHnLYQyKL
slope_table_43	reg	PIdKWDjIZqdVETXVKUyz
slope_table_430	reg	iYaojeeenaSObFkfIEyS
slope_table_431	reg	OvjWCALXGQonpSVNSUDx
slope_table_432	reg	QNSQONiKmlvpucXZsAKo
slope_table_433	reg	RKLbOFQSgMkwEdftvnBQ
slope_table_434	reg	hoPvrLDkwXFTkYESCUcp
slope_table_435	reg	hShwACbdYktXmGxyazAM
slope_table_436	reg	puehHutFkvCRvoGqbSYp
slope_table_437	reg	CSpvXCVkXjBnWvAFEiDG
slope_table_438	reg	GBnbMGmdJLNqPHpTRJqo
slope_table_439	reg	PQFlqUWXvhfFTKRniEDA
slope_table_44	reg	TeweoifYlvYAXegPEOev
slope_table_440	reg	mNQfwTdWpUOnxIhbTYfU
slope_table_441	reg	ldQowZgtPeXlzjFcyWQl
slope_table_442	reg	HYWHYpKWyjTHzWIzGNeE
slope_table_443	reg	vsHmuANStIQsYgoNHsHw
slope_table_444	reg	tYWmIUymjXADFjUmKFpP
slope_table_445	reg	OQmggBTvOqhAXBiDJeaP
slope_table_446	reg	EFcUAERFHbivPwgHAMQa
slope_table_447	reg	jpbydIYGKyCwhjgemImi
slope_table_448	reg	OVYjPuZDVHOTTeuFPkrT
slope_table_449	reg	DqhwOfIUxBzsVSgEjWzC
slope_table_45	reg	aHdPRBehEsBXhVSVEVGI
slope_table_450	reg	plztNCDwyKBliboMvXKs
slope_table_451	reg	GojVETmCGfWcYwVYimBv
slope_table_452	reg	aogDiFiAXQqphSrsQbJV
slope_table_453	reg	rCOKgSoVLfXaUWFdsBnJ
slope_table_454	reg	ZuONZDcmHxALaUULMEAA
slope_table_455	reg	KIjEeYrBOSrzUMqGYBsV
slope_table_456	reg	ZBocacKljeyYorCiQgzQ
slope_table_457	reg	mqazMnBgYnlLqLRzaNYx
slope_table_458	reg	oyfKvpCwkpoCCxTglCJr
slope_table_459	reg	NGNEGckWnRLaqnjOKOmx
slope_table_46	reg	EHDzFoGEUiKMcpmeZndO
slope_table_460	reg	cVWqyzzrUUodYFbrorBz
slope_table_461	reg	RjwugczIYXEQzzmUrnYh
slope_table_462	reg	lEqWgKBWIbLvYwrXeDtN
slope_table_463	reg	DhnZhzYLzUMXzuxLMdpR
slope_table_464	reg	WwogGcAbNuwPRaXHfllR
slope_table_465	reg	fymbKnqnRYaHIRuPXxle
slope_table_466	reg	nJWkhXEkUmrasSyMThpL
slope_table_467	reg	qXNWBYTrrKKKGSroThrT
slope_table_468	reg	OWgmvdYcTEmvwkEuDkJS
slope_table_469	reg	urpaOisfjSiDXEZoTBsG
slope_table_47	reg	iGWdFxfLkcoPAfSnTRiW
slope_table_470	reg	mveotDylkopgLZJFFBVl
slope_table_471	reg	CCXECvtOeIBEOFePtIRw
slope_table_472	reg	iYYwLjjGMjLikfxxrxIB
slope_table_473	reg	BJhcDugYXUoZuTXYBzJg
slope_table_474	reg	wpEZHrezpouBVvAiIOpn
slope_table_475	reg	omjfRcaEwaSdXWjgQYUv
slope_table_476	reg	aWXCrpICnOAsyXgkDTDT
slope_table_477	reg	HjXRkNnhDmrrYeoZLfga
slope_table_478	reg	zDWiKpAenkhcNZIBSNiT
slope_table_479	reg	UfyNbuBOwMXEdumKnlqN
slope_table_48	reg	OgwvxakMlGIDTjsTTTrF
slope_table_480	reg	LYSwVHbgNGVrAkuDLmxY
slope_table_49	reg	hweOwCSFFCFpnLABsNDz
slope_table_5	reg	QMFreKPqLMtYHbzgqBQA
slope_table_50	reg	kFILldZgHWqtwHcEyrEz
slope_table_51	reg	BHxWpRKaPloRmedcGnVS
slope_table_52	reg	jEDhTzjvJVSeQkYxJusx
slope_table_53	reg	nVWwCingLJiAmNkXNBse
slope_table_54	reg	hdQpCNCsCpWxWjyDHYIf
slope_table_55	reg	mYfjBwhqQaPjGDGuVzVT
slope_table_56	reg	sPdTjZhZROmcYPkfxnHK
slope_table_57	reg	VOSkkJBkJQjLTSFCXXZG
slope_table_58	reg	wnDMhVWFcihAknOuJWgt
slope_table_59	reg	ZJYNMlOSJujZtBMVfIcG
slope_table_6	reg	NlcVQzrrHSpHBCrquBjt
slope_table_60	reg	cUQgUjrarAoCxWvadhrh
slope_table_61	reg	ayPBmMeTERtfSkylBBkl
slope_table_62	reg	zjiIArXGbkjgPxxXfPxg
slope_table_63	reg	YERHnxdykgyyioNNZJSQ
slope_table_64	reg	rNuBwbgCniYGlSgOMCnE
slope_table_65	reg	VjtVxkxLZrdVPkMsyEqe
slope_table_66	reg	fFwIafFNLTVTiIeJUZOi
slope_table_67	reg	JofSpHHAILpRCvnGOmzf
slope_table_68	reg	OeYMhMfjeDdvkecHiLUT
slope_table_69	reg	tVOTCptQSOpsjFBXiksw
slope_table_7	reg	FSYqURbHbEaesQcTkdrx
slope_table_70	reg	AhXuWEaSPuUvIcwDuFWr
slope_table_71	reg	ekQuaIqPJyasZNSLaQOo
slope_table_72	reg	osvtoSWcIuWcmvZruLsS
slope_table_73	reg	BzXYfwLRzqKLxtfxvmZC
slope_table_74	reg	tgVDzxwqtPquEcvdvFrC
slope_table_75	reg	DzNsyDbNrzFrSyvQMHnd
slope_table_76	reg	iOnjZhBOoaDLaXXeVrwx
slope_table_77	reg	XwvNGtBVJXErWQRUuqBI
slope_table_78	reg	JJgTPGsdUTcAdufkeJgK
slope_table_79	reg	TfnRFMUqcGKfwYVkrOcp
slope_table_8	reg	qEtkygphCMCbDqrWtklY
slope_table_80	reg	kuHTqKTEGHJGjcgKEkCF
slope_table_81	reg	FfvTBiXNEwWARzrRMUYh
slope_table_82	reg	VMfdRrsDolDymeMDbscN
slope_table_83	reg	iPuXoTiWLBGZVYAHGaYO
slope_table_84	reg	BaxkmTikPlEanrOALJQn
slope_table_85	reg	TGPYgdsEOqsHqlpqyhVp
slope_table_86	reg	VZaWDekOPjcbcuLkmTCK
slope_table_87	reg	ceSSpUnFGIqusvzAQYyv
slope_table_88	reg	KkgZHqKRoBphLNurbXZv
slope_table_89	reg	BVfKHJmimWhfvhFZYdJC
slope_table_9	reg	TLjaqwEsoHtrvWTBQRsK
slope_table_90	reg	XWIoNGOmiUqZuWDNerJA
slope_table_91	reg	ymZNoaOSvkuMNFrKCZJc
slope_table_92	reg	JtPboWbpZfxqTBEEDYyf
slope_table_93	reg	NIzOkTmOrsmtdJpYgwkn
slope_table_94	reg	HPBVjcjYzqThfAZsuBko
slope_table_95	reg	RtOUSNvLjifycdHERnsH
slope_table_96	reg	RHqjRVMUmlsTYhhiTxqt
slope_table_97	reg	irQWRPjnSymTgyEWfOeV
slope_table_98	reg	gHMMxJFDpgQtSoSKsfzc
slope_table_99	reg	XrXzzUeQwqtdbHighLXh
state	reg	gStNdqadtalDMswfRuqW
table_input	reg	wKozjyqvbxpraCSNGCJY
table_output	reg	qaVKoOckmCbhBtxSbviM
target_byte_number	output	target_byte_number
target_slope	output	target_slope
temp	reg	qgkpXRmlTwkWNutDGWMM
time_counter	reg	YfuArrGnpBUyrJxEvVgI
word_last_flag	reg	LrLbKGgLtBSEzbICsDNb
word_last_flag_plane_cp	input	word_last_flag_plane_cp
word_last_flag_plane_cp_reg	reg	FGUJmfBLDaAxYUKmfnyF
word_last_flag_plane_mp	input	word_last_flag_plane_mp
word_last_flag_plane_mp_reg	reg	NhvFLRUduFzxNErEsMee
word_last_flag_plane_sp	input	word_last_flag_plane_sp
word_last_flag_plane_sp_reg	reg	DnfnMYzlPFszZtXlGDhW
word_last_flag_plus	wire	nhadPSkgCafxNJCdwkKp
wr_clk	input	wr_clk
zero_error_pass	wire	TLXWChymSkORZZFunpRb
zero_plane_number	input	zero_plane_number
zero_plane_number_reg	reg	tQSdMsmQOoDjgNvoiCmq
